-- ([A-Za-z0-9&()]+[`',’/%.!?]? ?[--]? ?[.?!]?)*


поезд прошел мимо -- a train went past
он думал, что это просто (не более чем) удача -- he thought it was a mere luck
он тоже ожидал (предвидел) хорошую сделку -- he was anticipating a good deal as well
контракт выглядит немного подозрительно -- the contract looks a bit suspicious
проболтаться (раскрыть секрет) -- to spill the beans


подчиняться прихотям -- be subject to the whim
забыть, отвлечься, перестать думать -- take my mind off things
быть обманутым -- to be deceived
коммуналка за свет -- light utility
возникать (not emergency) -- emerge


развивающаяся экономика -- emerging economy
все это складывается (всё сходится) -- it all adds up
этот новый ИИ не позволит водителям сбить пешеходов -- this new AI will prevent drivers from hitting pedestrians
береженого Бог бережет -- better safe than sorry
куда ты идешь с этим мешком птичьего корма, Джейк? -- where are you off to with that bag of birdseed, Jake?


в некоторых видах деятельности произошел такой спад -- there’s been such a decline in some activities
множество слов -- loads of the words
как же (чёрт побери) ты сюда попал? -- how on earth did you get here?
я с ней столкнулся -- I bumped into her
а мне за это когда-то попадало? -- did I ever get in hot water for that?


бензин стоит целое состояние -- gasoline costs a fortune
давайте пока на этом закончим -- let's call it a day for now
я уже выучил свои строки наизусть -- I already learned my lines by heart
традиционная медицина -- traditional/conventional medicine
извините за причиненные неудобства -- sorry for the inconvenience caused


подавленный, сокрушенный, перегруженный -- overwhelmed
достаточный сон (по часам) -- sufficient sleep
цитата, цитирование -- citation
держи меня в курсе -- keep me in the loop
должное внимание -- due attention


выдвижной ящик -- drawer
она подчеркивает важность изучения английского языка -- she stresses the importance of learning English
для меня было бы катастрофой, если бы я потерял работу -- it would be a disaster for me, if I lost my job
изучение английского требует (предполагает) дисциплины -- learning English call for discipline
у меня есть подозрение, что он пригласил меня на свидание только потому, что мой брат убедил его -- I have a suspicion that he only asked me out because my brother persuaded him to


идти в ногу со временем -- to keep up with the times
быть не в себе (слететь с петель) -- to be off hinges
идёт молва(ходят слухи), что экзамены собираются отменить -- there is a rumor going around that the exams are going to be cancelled
ты впустую тратишь моё время -- you wast my time
иногда сложно разобрать, что говорят носители языка -- sometimes it is hard to make out what native speakers say


мне вcегда сводит шею (ломит шею) после долгого рабочего дня -- I always get crick in the neck after a long working day
должно быть (судя по всему) я ударил голову сильнее, чем думал (must have + V3) -- I must had hit my head harder than I thought
ты не возражаешь, если я открою окно -- do you mind if I open a window
она неделями размышляла о том, говорить ему об этом или нет -- she ruminated for weeks whether to tell him or not
схватиться (воспользоваться) за шанс -- sieze the chance


я был застенчивым ребенком (used to -- конструкция «used to» нужна для выражения повторяющихся действий в прошлом) -- I used to be a shy kid
я давно не видел своего друга -- I haven't seen my friend in a while
это преуменьшение сказать, что это мальчик умный -- it is understatment to say that this boy is clever
очень прошу (ну пожалуйста) -- pretty please
мы будем продолжать беспокоить вас -- we will keep bugging you


крутые времена требуют крутых решений -- desperate times call desperate measures
детские нетерпеливые (жаждущие) лица -- the children's eager faces
что вас так зацепило (поглотило, завладело) в «Гарри Поттере»? -- what is it about Harry Potter that so engross you?
рыба борется за выживание, когда уровень воды в озере падает -- fish struggle for survival when the water level drops in the lake
в 60% опрошенных домохозяйств оба супруга ходили на работу -- in 60 percent of the households surveyed both spouses went out to work


реклама привлекает (соблазняет, заманивает) клиентов -- the adverts entice the customer
по своей природе импатичный -- inherently empathetic
проводить исследование -- conduct a research
страховщики должны будут оценить ущерб от наводнения -- the insurers will need to assess the flood damage
выделить время (деньги и прочее) -- to allocate time (money, etc)


изменения коснутся любых женщин, находящихся в декретном отпуске -- the changes will affect any women on maternity (paternity for men) leave
это маловероятно, но я мог бы спросить лабораторию -- it may be a long shot, but, I could ask the lab
у нас закончилось время -- we run out of time
я прошу прощения за это -- I do apologize for that
он потерял работу во время сокращения -- he lost his job during a downsizing


не кричи (ори, реви) при людях -- don't bawl in public
я стараюсь смотреть фильмы на английском хотя бы раз в неделю -- I am trying to watch movies in English at least once a week
она начала зевать -- she starts to yawn
придерживаться плана -- stick to the plan
наоборот, я очень люблю музыку -- on the contrary, I love music very much


я хотел бы записаться на прием к доктору Эванс, пожалуйста -- I would like to make an appointment with Dr. Evans, please
он привык заниматься историческими исследованиями -- he is used to doing historical research
платить за коммуналку -- pay for utilities
это крайне важно -- it is crucially important
внедрить ПО -- roll out a software


я опаздываю -- I am running late
это замедляет/ускоряет реакцию -- it slows down/speeds up the reaction
нажить проблем -- get in hot water (be in trouble)
поладить с ним / подружиться с ним -- hit it off with him
я с сомнением к этому отношусь -- I am sceptical about that


мне трудно найти это место -- I have a hard time finding this place
благородный человек -- noble man
есть обильные (избыточные) доказательства вредного воздействия автомобилей на окружающую среду -- there is abundant evidence that cars have a harmful effect on the environment
подавать завтрак -- serve breakfast
давайте не будем сидеть здесь с урчащими животиками -- let's not just sitting here with our tummies rumbling


все налетайте (на еду) -- everybody dig in
спасибо! Не откажусь -- thanks! I don't mind if I do
оконная витрина -- window display
мы пытаемся дать этим оборванцам шанс, но воспитание -- we are trying to give these wretches a chance but breeding
вы выглядите восхитительно (очаровательно, прекрасно) -- you look ravishing


преследовать увлечения, связанные с писательством -- pursue writed-related passions
учитывая (при условии), что я пользователь вашего продукта -- given that I am a user of your product
я ухватился за возможность сделать что-л -- I jumped at the chance to do smth
дурацкое (глупое) поведение -- moronic behavior
держись подальше от огня -- stay away from the fire


его назвали в честь отца -- he was named after his father
мне хочется, чтобы ты была счастливой -- all I want is for you to be happy
дети бегали повсюду (везде) -- the kids were running all over the place
никто не ценит тебя, не так ли? -- nobody appreciates you, do they?
сколько душе угодно -- to your heart's content


у меня все хорошо -- I'm doing fine
его адвокаты решили не продолжать дело -- his lawyers have decided not to proceed with the case
помощь пожилым -- assisting the elderly
глаза-бусинки -- beady eyes
он прокрался на мой двор -- he sneaks in my yard


волк пожирает свою жертву -- a wolf gobbels its victim
она была немощной (дряхлой) -- she was infirm
он хитрый как лиса -- he is as crafty as a fox
срочно получить данные для собрания акционеров -- get the figures for shareholders meeting urgently
я терпеть не могу -- I can't stand


мы купили/приобрели маленькою местную компанию -- we bought/took over/acquired a small local company
мы были куплены/приобретены большой компанией -- we were bought/taken over/were acquired by a big company
мы объединились с -- we merged with
важной вехой (важным этапом) стал (был) -- an important milestone was when
продажи выросли резко (быстро) -- sales grew rapidly


продажи сильно пострадали, когда закон изменился -- sales suffered badly when the law changed
мы вошли на рынок США -- we entered/move into the US market
главной составляющей нашего успеха является наш персонал -- a key factor in our success has been our stuff
перестараться, переусердствовать -- overdo
вам нужна какая-нибудь помощь сегодня -- are you in need of any assistance today?


мы специализируемся на программном обеспечении -- we specialize in software
мы предоставляем сетевые (интернет) решения -- we provide network solutions
мы находимся в Москве -- we are based in Moscow
наш основной рынок это Индия -- our main market is India
мы лидеры рынка -- we are the market leaders


мы вторые на рынке -- we are the second in the market
наша доля на рынке порядка 25% -- we have a market share of around 25%
наши основные конкуренты -- our main competitors
компания была основана в 1998 моим отцом -- the company was founded/established/set up in 1998 by my father
мы перенесли наш главный офис в Москву -- we moved our Head office to Moscow


внутренний рынок -- domestic market
конкурент -- competitor
годовой оборот -- annual turnover
финансовые показатели -- financial performance
дочернее предприятие -- subsidiary


приобретать -- acquire
продажи превысили 7 миллионов -- sales passed 7 millions
средство, объект, сооружение, завод -- facility
продавать/распродавать -- sold off
закрывать/закрыть -- close down


решимость, устремленность, упорство -- determination
составить резюме -- craft CV
набросать план -- draft the plan
культурный, изысканный, искушенный (в искусстве, культуре) человек -- sophisticated person
сложные технологии -- sophisticated technologies


прибыльный бизнес (2 варианта) -- lucrative/profitable business
с раннего утра идёт дождь -- it is been raining since early morning
теракт -- terroristic attack
творог (крупчатый) -- curds
Дэнис устал (истощён, измучен) за эти дни -- Dennis was exhausted these days


я не совсем понимаю -- I don't quite follow
не могли бы вы подробнее остановиться на этом? -- can you elaborate on that?
не могли бы вы уточнить? -- could you be more specific?
иначе говоря -- put it another way
позвольте мне уточнить это -- let me clarify that


это не касается вас напрямую -- it doesn't concern you directly
занимать, брать в долг -- borrow
плиточный пол/кафельный пол -- tiled floor
в общем и целом -- all in all
могу я заглянуть позже? -- could I pop round later?


подчеркивать, акцентировать -- emphasise
используемые слова -- words being used
рассеянный -- distracted
раздражители -- stimuli
привлекать, увлекать, занимать, заинтересовывать -- engage


а так же вашим нутром -- as well as with your guts
знающий, осведомленный -- aware
иметь смысл -- make sense
я делаю это сам -- I do it myself
основные, главные элементы (суть) -- the nuts and bolts


мы можем слушать вдвое больше, чем говорить -- we can listen twice as much as we speak
только чтобы осознать -- only to realize
он просто не понимает -- he just doesn't seem to grasp
спорить -- arque
враждебность, злоба -- animosity


зонд -- probe
невероятно, чрезвычайно -- incredibly
бросать, метать -- toss
вы должны признать (принять) истинность ее аргументов -- you must acknowledge the truth of her arguments
точнее -- more accurate


наши фильтры восприятия -- our perceptual filters
глина -- clay
мэр не предвидел политической реакции (негативная реакция, возражения) на свое предложение -- the mayor foresaw no political backlash against his proposal
предлагаемое сокращение заработной платы возмущает персонал -- the proposed pay cut outrage the staff
студенты надели черные мантии (платья) на выпускную церемонию -- students wore black gowns for the graduation ceremony


собирать -- gather
ткань, материал -- fabric
выбрасывать -- discard
лакированная кожа -- patent leather
пресс-секретарь -- spokeswoman


избавиться от -- get rid of
львиная доля -- fair share
спор, дискуссия -- controversy
отсутствие -- lack of
ситуацию можно было сдержать -- the situation could have been contained


исправлять -- rectify
пополнять -- replenish
он разорвал с ними отношения -- he is cutting  ties with them
очаровывать -- fascinate
по всей видимости -- apparently


в возрасте 5 лет -- as young as 5 years old
безработица -- unemployment
зарплата белым воротничкам -- salary
зарплата синим воротничкам -- wage
он поскользнулся -- he slipped


я не жалею, что сделал это -- I don't regret I did it
я должен успеть на самолёт сегодня вечером -- I have to catch a plane tonight
было около половины двенадцатого -- it was around half past eleven
доступный -- affordable
тем не менее -- nonetheless, nevertheless


одежда -- apparel, garment, clothes
H&M выступает (защищает) за экологичную моду -- h&m advocates for sustainable fashion
труд, работа -- labor
колекция состоит из -- the collection constitute of
это имеет отношение к.../это связано с... -- it has to do with


у меня страсть к... / я очень люблю(делать что-то) -- I have a passion for
бессознательный -- unconscious
сказочный -- dream like
оковы -- shackles
пренебрегать -- neglect


посвящать -- dedicate
ты не можешь не восхищаться -- you can't help but admire
благодаря этому -- due to
я должен был (сделать что-то) -- I had to
абажур -- lamp shade


насколько я знаю -- as far as I know
ВНЖ -- residence permit
у них есть соискатели -- they have applicants
сомнение -- hesitation
он хочет, чтоб ты встретился с ним -- he wants you to meet him


вести протокол встречи -- take minutes of a meeting
нерушимый союз -- invincible alliance
что-то положительное в плохом -- silver lining
прачечная -- laundry
отмывание денежных средств -- money laundering


в стоимость входит проезд и проживание, но питание оплачивается дополнительно -- the price includes travel and accommodation but meals are extra
сколько это стоит? 1 -- how much does it cost?
сколько это стоит? 2 -- how much is it?
платить наличными/кредиткой -- pay by cash, pay by credit card
слабые стороны -- weaknesess


сильная сторона -- strong point, strong suit
оставаться верным -- remain loyal
записаться на курс -- enroll in the course
наиболее соответствующий кандидат на позицию -- the best fit for the position
более или менее -- more or less


компенсировать -- compensate
что подразумевалось? -- what was inferred?
что мужчина имеет ввиду? -- what is implied be the man?
сомневаться -- to doubt
хлопья (завтрак) -- cereal


идти на работу -- go to work
идти домой -- go home
заполнить пропуски в форме -- fill in the gaps in the form
обязательные предметы -- obligatory subjects
плохое поведение -- misbehave


приветствовать кого-либо -- to greet someone
плохие последствия -- bad consequences
заинтересованная сторона -- concerned party
внести вклад в компанию -- to contribute to the company
не совсем -- not exactly


коллеги -- teammates, workmates, colleagues, peers
он должен вести заседание (по идее, по его должностным обязанностям) -- he is supposed to hold a meeting
обычный человек -- regular person
всё, к чему ты прикасаешься, превращается в золото -- everything you touch turns into gold
самый богатый мужчина -- the wealthiest man


элитный бренд -- high end brand
акции компани -- shares of the company
водолеи обычно мечтают о собственном бизнесе -- aquarius tend to dream of their own business
выражение лица -- facial expression
как переводится "стол"? -- what is the translation for table


ген.директор ушел в отставку в 60 -- CEO resigned at 60
им требуется стимуляция -- they require stimulation
они умеют выполнять детальную работу -- they have knack for detailed work
через аналитическую призму -- through analytical lens
сдвинуться с мертвой точки -- it gets off the ground


с другой стороны / зато -- on another hand
в некотором смысле -- in a sense
она здесь находится 10 мин -- she has been here for 10 minutes
отвечать простым требованиям --  to meet simple needs
восстановительный период -- rehabilitation period


анестезия -- anesthesia
отложить, поставить на паузу -- put on hold
он ушёл из клуба -- he quit the club
он скоро бросит свою работу -- he will quit his job soon
кстати, на самом деле -- as the matter a fact


копия -- replica
моя реплика коротка -- my phrase is short
сомнение -- hesitation
комплимент -- compliment
братья друг друга дополняли в своем бизнесе -- the two brothes complemented each other in their business


важный -- essential
современный, актуальный -- up-to-date
обновлять -- update
кафе с собой, пожалуйста -- a coffee to go, please
еда на вынос -- carry-out food, take-away food


слияние и поглощение -- mergers and acquisitions
я вышла из отеля -- I left the hotel
прямо сейчас -- at the drop of a hat
ей в последнее время нездоровится  -- she has been under the weather lately
он похож на него -- he takes after him


я работаю в этой компании8 лет -- I have been working for this company for 8 years
я имел опыт со всеми описанными ситуациями -- I have experienced all the situations described
арендодатель -- landlord
арендатор, жилец -- tenant
воспринимать -- perceive


захватить индустрию -- take over the industry
существенная доля -- fair share
обвинять -- accuse
оконное стекло (плоский лист стекла) -- pane of glass
разнообразная коллекция музыки -- a diverse collection of music


в одном памятном случае в начале этого года -- in one memorable instance from earlier this year
промежуток времени -- time lapse
в итоге они проиграли игру -- the bottom line is that they lost the game
другие ощутимые преимущества включают увеличение заработной платы -- other tangible benefits include an increase in salary
сильный снегопад помешал путешествию -- heavy snow disrupted travel


я регулярно посещаю технические встречи -- I regularly attend tech meetups
наркоман -- junkie
почему он избегает меня -- why is he shuning (shun) me
студенты справились (выполнили, завершили) с заданием менее чем за десять минут -- the students accomplished the task in less than ten minutes
инженеры потратили много месяцев на доработку (улучшение) программного обеспечения.  -- engineers spent many months refining (refine) the software


ему не хватает смирения, чтобы признать, что он не прав -- he doesn't have the humility to admit when he's wrong
лучший пост должен быть тщательным и кратким и ясно передавать ожидания от должности, вместа с соответствующей информацией о компании -- the best post is thorough and succinct and clearly conveys expectations for the role, along with relevant information about the company
достижимая цель -- attainable goal
её новая книга посвящена тому, как мы можем оценивать интеллект животных -- her new book looks at how we can evaluate animal intelligence
моя экспертиза -- my expertise


глубокие знания -- in-depth knowledge
предоставить проект -- implement the project
ладить с коллективом -- get on well with colleagues/Have a good rapport with colleagues
это не имеет отношения к делу -- it is irrelevant
неработающая платежная страница негативно влияет на продажи -- broken payment page has a disruptive effect on sales


до сих пор -- so far
а также -- as well as
арендная ставка -- rent rate
раньше я интересовался математикой -- I used to be interested in math
читать вслух -- read out loud


брать на себя руководство проектом -- to take charge of a project
инвестиции -- investment
расследование -- investigation
(не) уложиться в срок -- (fail to) meet a deadline
я попробовал -- I tasted


прозрачность в бизнесе -- transparency in business
мы сдаём квартиру -- we rent out an apartment
постельное белье -- bed linen/bedding
курс обмена валют -- exchange rate
переменчивая ставка -- volatile rate


самостоятельная оценка -- self-assessment
он (не) подходит на эту позицию -- he is (not) cut out for this position
мне не нравится влажность этого климата -- I don't like the humidity of this climate
грыжа -- hernia
ортопед -- orthopedist


ЛФК -- therapeutic physical culture
связки -- ligaments
сустав -- joint
азотная кислота растворяет большинство органических тканей -- nitric acid will dissolve most animal tissue.

понедельник -- Monday
вторник -- Tuesday
среда -- Wednesday
четверг -- Thursday
пятница -- Friday
суббота -- Saturday
воскресенье -- Sunday


глагол -- verb
существительное -- noun
прилагательное -- adjective
местоимение -- pronoun
числительные -- numerals
наречие -- adverb


ломаться (о технике) -- break down
завершиться/закончиться -- be over
вломиться в/ворваться в -- break in
продолжить (делать что-то) -- carry on
зайти за кем-то -- call for smb


выписываться/освобождать номер -- check out
айда/давай/живее/поторопись -- come on
расходиться/расставаться -- break up
проводить/выполнять(исследование/план) -- carry out
растить/воспитывать детей -- bring up


Илон Маск — известный предприниматель -- Elon Musk is a famous entrepreneur
у нее отличные предпринимательские способности -- she has excellent entrepreneurial skills
оборот постепенно увеличивался в мае -- turnover went up gradually in May
в последнее время наблюдается снижение текучести кадров -- there has been a decrease in staff turnover recently
компания предлагает очень щедрый компенсационный пакет -- the company is offering a very generous remuneration package


работа сделана последовательно и аккуратно -- the work is done with consistency and precision
он взял 6-месячный творческий отпуск и путешествовал по Европе -- he took a 6-month sabbatical and travelled around Europe
задание было выполнено с большой точностью -- the task was performed with great accuracy
мы призываем всех наших сотрудников пользоваться общественным транспортом -- we encourage all our staff to use public transport
расплывчатый -- vague


мода, популярность -- vogue
соединительная ткань -- joint tissue
совместное предприятие -- joint venture
самодостаточность -- self-sufficiency
на него можно положиться -- he can be relied on


длительный перелёт, дальний рейс -- long-haul flight
ржавчина -- corrosion/rust
высокомерный -- arrogant
устойчивое словосочетание -- collocation
это препятствует прогрессу -- it hinders the progress


прямо к сути дела -- straight to the point
прочный навык, высокое мастерство -- solid skill
подделка -- bogus
реанимационное отделение -- emergency room
потерять сознание -- lose consciousness


тщательная проверка -- a thorough check-up
ненужный -- unneeded
мы расстроились -- we got upset
это неизбежно -- it is inevitable
приспособиться к этому -- adapt to it